1111111111111111111111111
1000000000000000000000001
1000000000000000000000001
1000001110000000000000001
1000000010000000000000001
1000000011111111111111111
1111000010000000000000001
1000000010000000000000001
1000000010000000000000001
1000001110000000000000001
1000000000000000000000001
1000000000000001111100001
1111000000000001111100001
1000000000000000000000001
1000000000000000000000001
1000001111110000000000001
1000001111110000000000001
1111111111111111111111111
1111111111111111111111111