0000000000000
0000000000000
0000000000000
0000000000000
0000000000000
0000000000000
0000000000000
0000000000000
0000000000000
0000000000000
0000000000000
0000000000000
1111000000000
1000000000000
10000000000000
1000001111110
100000111111000000
111111111111111111
111111111111111111